                                                                                                         
                                                                                                         
                                                                                                         
                                                                                                         
                                                                                                         
                                                                                                         
                                                                                                         
                                                                                                         
                                                                                                         
    ````````````      ```````     ```````````   ```````````````````````      ``         ```````          
   ``..,,.......``   ``.....``   ``...,......````......``.....,,,.....``   ``````      ``.....``         
  `,;;;;;;;;;;:,..```.:;;;;;:.```..:;;''';::;,`.:;;;;;;,:;;;;;;';;;;;;:`` ``.::.`     `,;;;;;;;.         
  `,;''''''''''';:.``,;''''';.``.,;'''';''''':..;'''''':;''''''''''''';.` `.:'':.`    `:'''''';.         
  ``,;''';;:;;'''':.`.,;''';,``.:''';:,.,:;'';...:''';,,;';;;'''';;;;';.```,;'';,`    `.,'''':.`         
   `,;''':,..,;'''':..,;''':...,''';,..`..,;';.`.:''';,,;;,,,;''';,,,;;.``.:'''':.`   `.,'''':.`         
   `,;''':.``.,;''';,.,;''':..,;''',.`````.,';.`.:''';,.;:..,;''':,..:;.``.;'''';,`    `,'''',.`         
   `,;''':.` `.:'''':.,:''':..:''';,``   ``.::.`.:''';,`.```.:''':.```.```,'''''',.`   `,'''',.          
   `.;''':.`  `,;''';,,:''':,,;''':.`   ``..,.``.:''';,`   `.:''':.`    `.:'''''';.`   `,'''',.          
   `.;''':.`  `.:'''',,:''':,,'''':.`   `,,:::,..:''';,`   `.:''':.`   ``.;';;'''',.`  `,'''',.          
   `.;''':.`  `.:'''':,;''':,:'''':.`  `,'''''':.:''';.`   `.:''':.`   `.:''::;''':.`  `,'''',.          
   `.;''':.`  `.:'''':,;''':,:'''':.`  `.:'''';,.:''';.`   `.:''':.`   `.;';,:;''';,`  `,'''',.          
   `.;''':.`  `.:'''',,:''':,:'''':.`  `.,;''':..:''';.`   `.:''':.`  `.,''';;''''':.` `,'''',.          
   `.;''':.`  `,;''';,,:''':,,'''';.`   `,'''':..:''';.`   `.:''':.`  `.;'''''''''';.```,'''',.      `   
   `,;''':.` `.,'''':.,:''':,,;''';,.`  `,;''':..:''';,`   `.:''':.` ``,'';::::;'''',.``,'''',.   ``.,`  
   `,;''':.``.,:'''',.,;''':,.:'''':.````,;''',..:''';,`   `.;''':.` `.:'',....,;''';.`.,'''':.```..:'.` 
   `,;''':,...:'''':..,;''':,..;''';,..`.,'''',..:''';,`   `.;''':.``.,;';..```,:'''',..,'''':,....:';`` 
   `,;''';:,:;'''':.``,;''';,..,;''';:..,:'''',..:''';,`   `,;''';,``.:'':.`  `.,'''':..,'''';::::;'':`` 
  `,;''''''''''';:.``,;''''';.`.,:'''';;;'''';..:;'''';,`  .;''''';..:''';:`  `.;''''';:;'''''''''''',`` 
  `,;;'''';;;;:,..```,;;''';;.```.,;;'''''';:.`.;;''';;,`  .;;''';;..;;;;;:`   .;;''';;;;'''''';;'';:.`  
   `..,,,.......``   `..,,,..`  ``...,,,,,,..````..,,..`   `..,,,..``.....``   `..,,,.....,,,,.......``  
    ````````````     ```...````` ````.......``````....```` ```...````````````````````````````````````    
                    ``........```````````....`````.......`````...``   ``......`````                      
                    `,;;;:,;;;:,`.:;:...,:;;;:,.`,:;;;;;:,.`.:;;;:.   `,;;;;;;:,.``                      
                    `,''';:;'';,.,;';,.:'';;;';,.,;'''''';,..:''':.`  `,'''''''';,.`                     
                    `.;'';,:'';,..;':,:'':..,;'':,:'';:;'';..,''',.`  `.;'':,:;'';,``                    
                    `.:'';::''':,,;;,:'';,...:'';::'';::''',.,''',.`  `.;'':,.,;'':.`                    
                    `.,;''::''';,:':,;'';,.`.,''':;'';:;''',.,''',.`  `.;'':...:''',`                    
                     `.:'';:'''':;',,;'';.```,;'';;''';''':..,''',`   `.;'',.`.,''',.`                   
                     `.,''';'''';';,,;'';.```,;'';;'''''';,..,''',`   `.;'',.`.,''':.`                   
                      `,;''''''''':.,;'';.```,;'';;'''''':,..,''',.` `.,;'',.`.,''',.`                   
                      `.:'''':'''',..:'';,.`.,''':;''';'';,..,''',.```,,;'':...:'';,`                    
                      `.,''';:;'';,`.,''',...:'';,:'';:;'':..,''',...:':;'':..,;'':.`                    
                       `.;'':,:'':.``.:'':,.,;';,,:'';,,;'':,,'''::::';,;'':,:;'':.``                    